0,0,0,0,0,0,0,0,0,0,0,0,0,0,0,0,0,0
0,0,5,5,5,0,0,0,0,0,0,0,0,0,0,0,0,0
0,0,5,5,5,0,3,3,3,3,3,3,3,0,7,1,7,0
0,0,3,3,3,0,7,1,3,3,3,1,3,0,3,3,3,0
0,0,3,3,3,0,3,3,3,3,3,3,3,0,3,3,3,0
0,0,3,3,3,0,0,0,0,0,3,3,3,0,3,0,3,0
0,0,3,3,3,0,0,0,0,0,3,3,3,0,3,3,3,0
0,0,3,3,3,0,0,6,7,0,3,3,3,0,0,3,0,0
0,0,3,3,3,0,0,3,3,3,3,3,3,0,0,3,0,0
0,0,3,3,3,0,0,3,3,3,3,3,3,3,3,3,0,0
0,0,3,3,3,3,3,3,3,3,4,4,4,3,3,3,0,0
0,0,3,3,3,3,3,3,0,3,4,4,4,3,3,3,0,0
0,0,3,3,3,3,3,3,3,3,0,0,0,3,3,3,0,0
0,0,2,2,2,0,0,3,3,3,0,0,0,3,3,3,0,0
0,0,2,2,2,0,0,3,3,3,0,0,0,3,3,3,0,0
0,0,3,1,3,0,0,1,3,1,0,0,0,3,1,3,0,0
0,0,3,3,3,0,0,7,1,7,0,0,0,1,7,1,0,0
0,0,0,0,0,0,0,0,0,0,0,0,0,0,0,0,0,0
