0,0,0,0,0,0,0,0,0,0,0,0,0,0,0,0,0,0
0,0,0,0,0,0,0,0,0,0,0,0,0,0,0,0,0,0
0,0,0,0,0,0,0,0,0,0,0,0,0,0,0,0,0,0
0,0,0,0,0,0,0,7,3,3,7,0,0,0,0,0,0,0
0,0,0,0,1,3,3,3,1,1,3,3,3,1,0,0,0,0
0,0,0,0,3,4,4,3,3,3,3,4,4,3,0,0,0,0
0,0,0,0,3,4,4,3,3,3,3,4,4,3,0,0,0,0
0,0,0,3,3,3,4,4,3,3,4,4,3,3,3,0,0,0
0,0,0,3,1,3,3,3,7,7,3,3,3,1,3,0,0,0
0,0,0,3,1,3,3,3,7,7,3,3,3,1,3,0,0,0
0,0,0,3,3,3,3,3,3,3,3,3,3,3,3,0,0,0
0,0,0,3,3,3,3,3,3,3,3,3,3,3,3,0,0,0
0,0,0,3,3,0,0,3,3,3,3,0,0,3,3,0,0,0
0,0,0,3,3,0,0,3,3,3,3,0,0,3,3,0,0,0
0,0,0,7,3,3,3,3,3,3,3,3,3,3,7,0,0,0
0,0,0,0,0,0,0,5,5,5,5,0,0,0,0,0,0,0
0,0,0,0,0,0,0,5,5,5,5,0,0,0,0,0,0,0
0,0,0,0,0,0,0,0,0,0,0,0,0,0,0,0,0,0
